####################
#        #         #
# ## ### # ### ### #
#                  #
# ## # ##### # ### #
#    #   #   #     #
#### ### # ### #####
#   # #       # #  #
##### # ## ## # ####
#       #   #      #
##### # ## ## # ####
#   # #       # #  #
#### # ##### # #####
#        #         #
# ## ### # ### ### #
# #            #   #
## # # ##### # # ###
#    #   #   #     #
# ###### # ######  #
####################